1
12
15
###########....
#.......c.###..
####......#.#..
.#.########.#..
##...#..b#..#..
#.a.#...#...###
####.#.#d###..#
......#...e#xx#
.#....#########
.#.x..#..#.....
.######.c#.....
......####.....